#0;room6.txt
0    G
WWWWWWWSWW
     t S
WWW t tWW
WWW    WW
SWWHWWWWW
WWW   sWW
WWWWWWWWWW
 J  S
WWWWWWWWWW