PGG  G
WWWWWWWWWS
         S
SWWWWWttWW
S  m W   W
SWWWWWSWSW
S   s SWSW
WWWWWWWWSW
 J      SW
WWWWWWWWWW