#0;room7.txt
0G   G
WWWWWWWWWS
         S
H        S
SWWttttt S
SWWWWWWW S
S   s    S
WWWWWWWWWS
 J       S
WWWWWWWWWW