WP   G
WWWWWWWWWS
         S
SWWW tt WW
S         
SWWWWW  WW
S         
WWWWWWWSWW
 J     S H
WWWWWWWWWW