#0;room4.txt
W0G      S
WWWWWWWWWS
         S
SWWWWW ttW
S    m
SWWWWSW  W
S t  S  tW
WWWWWWWSWW
 J     SH
WWWWWWWWWW