#0;room5.txt
  0G   G
WWWWWWWSWW
       S H
SWWWWW ttW
S s      W
SWWWWWW  W
S  t    tW
WWWWWWSWWW
 J    S  H
WWWWWWWWWW