PGG  G
WWWWWWWWWW
     t
WWWt H tWW
WWWWWWWW W
W   s t  W
WWWWWWWWWW
 J     S
WWWWWWWWWW