#0;room8.txt
0G   G
WWWWWWSWWS
      SW S
SW WWWWWSW
S   m H SW
SWWWWWWWWW
S        W
WWWWWWWWSW
 J   t  SW
WWWWWWWWWW